"filename", "language", "C#", "comment", "blank", "total"
"c:\lbm_2d\Assets\Scripts\ChannelFlow.cs", "C#", 206, 37, 11, 254
"c:\lbm_2d\Assets\Scripts\ColorHeatMap.cs", "C#", 49, 0, 4, 53
"c:\lbm_2d\Assets\Scripts\D2Q4AdvectionMain.cs", "C#", 164, 4, 5, 173
"c:\lbm_2d\Assets\Scripts\D2Q4ComputeShader.cs", "C#", 103, 10, 22, 135
"c:\lbm_2d\Assets\Scripts\D2Q4Main.cs", "C#", 166, 4, 6, 176
"c:\lbm_2d\Assets\Scripts\D2Q5Main.cs", "C#", 185, 4, 5, 194
"c:\lbm_2d\Assets\Scripts\D2Q9Main.cs", "C#", 213, 4, 8, 225
"c:\lbm_2d\Assets\Scripts\FDMMain.cs", "C#", 79, 1, 7, 87
"c:\lbm_2d\Assets\Scripts\HeatMapScene.cs", "C#", 291, 13, 21, 325
"c:\lbm_2d\Assets\Scripts\IBLBMDKT.cs", "C#", 0, 458, 35, 493
"c:\lbm_2d\Assets\Scripts\IBLBMSingle.cs", "C#", 333, 10, 24, 367
"c:\lbm_2d\Assets\Scripts\LBMCage.cs", "C#", 280, 18, 21, 319
"c:\lbm_2d\Assets\Scripts\LBMCylinder.cs", "C#", 280, 14, 19, 313
"c:\lbm_2d\Assets\Scripts\LBMFreePolygon.cs", "C#", 613, 29, 44, 686
"c:\lbm_2d\Assets\Scripts\LBMLap.cs", "C#", 288, 12, 29, 329
"c:\lbm_2d\Assets\Scripts\LBMNatConv.cs", "C#", 470, 27, 59, 556
"c:\lbm_2d\Assets\Scripts\LBMNatConv1DArray.cs", "C#", 293, 40, 30, 363
"c:\lbm_2d\Assets\Scripts\LBMNatConvComputeShader.cs", "C#", 192, 104, 35, 331
"c:\lbm_2d\Assets\Scripts\LBMNatConvMDArray.cs", "C#", 310, 24, 30, 364
"c:\lbm_2d\Assets\Scripts\LBMNatConvThermPartcom.cs", "C#", 418, 50, 46, 514
"c:\lbm_2d\Assets\Scripts\LBMNatConvThermoPhoresis.cs", "C#", 453, 53, 36, 542
"c:\lbm_2d\Assets\Scripts\LBMNatConvWithParticles.cs", "C#", 632, 30, 67, 729
"c:\lbm_2d\Assets\Scripts\LBMPoiWithParticle.cs", "C#", 363, 36, 35, 434
"c:\lbm_2d\Assets\Scripts\LBMPoiWithPolygon.cs", "C#", 463, 54, 41, 558
"c:\lbm_2d\Assets\Scripts\LBMTherm.cs", "C#", 189, 11, 19, 219
"c:\lbm_2d\Assets\Scripts\LBMVicsek.cs", "C#", 430, 34, 29, 493
"c:\lbm_2d\Assets\Scripts\Lbmpoi.cs", "C#", 238, 16, 25, 279
"c:\lbm_2d\Assets\Scripts\LidDrivenCavity.cs", "C#", 206, 5, 11, 222
"c:\lbm_2d\Assets\Scripts\PolygonTest.cs", "C#", 374, 55, 38, 467
"c:\lbm_2d\Assets\Scripts\Utils.cs", "C#", 547, 5, 28, 580
"c:\lbm_2d\Assets\Scripts\VectorField.cs", "C#", 120, 4, 2, 126
"Total", "-", 8948, 1166, 792, 10906